{
  "rooms": [
    {
      "id": "basic",
      "tiles": [
        "#####",
        "#S..#",
        "#...#",
        "#..E#",
        "#####"
      ]
    }
  ]
}
